1111111111111
1MM10000000C1
1M000111110M1
1P0M11E0000C1
1111111111111