1111111111111
100100C0000C1
1M000111110M1
1P0011E0000C1
1111111111111