1111111111111
10010000000C1
10M00111110M1
1P0011E0000C1
1111111111111