1111111111111111111111111111111111
1EM000000000000C0M000C000000000001
1010010100100000101M01000M0001M101
10100100101M101000100100000001M101
1P0000000CM0C0000000000M00000000C1
1111111111111111111111111111111111