11111111111111
1C0000M0000001
11101111110M01
10000000010101
101111M101C1P1
100001M1010111
1M1000E1C10001
10101111110001
10100000000101
101111111001M1
100C1M00001101
10011001111M01
1M0000000000C1
11111111111111