"................................",
"................................",
"................................",
"................................",
"....                        ....",
".... ......... ......... .. ....",
".... ......... ......... .. ....",
"....    ..            .. .. ....",
".... ..... .......... .. .. ....",
".... ..... .......... .. .. ....",
".... ..... .......... .. .. ....",
".... ..        .. ... ..... ....",
".... ......... .. ... ..... ....",
".... ......... .. ... ..... ....",
"....       ... .. ... ..    ....",
".... .. ......... ... ..... ....",
".... .. ......... ... ..... ....",
".... .. ...           ..... ....",
".... .. ................ .. ....",
".... .. ................ .. ....",
".... .. ................ .. ....",
".... ..             .... .. ....",
".... ..... ............. .. ....",
".... ..... ............. .. ....",
".... ..    ...           .. ....",
".... .............. ....... ....",
".... .............. ....... ....",
".... .............. ....... ....",
"....                        ....",
"................................",
"................................",
"................................"
