1111111111111111111
1000000000000000001
1000000010000C00001
1000000111000000001
10000010C0000000001
100001C000000000001
1000101000111100001
1001111C000111C0001
1001111100011110001
1011111100111110001
1001010110111111101
10011011100111111C1
1010011110C11111101
1011111100111111101
10111E0001110111101
10111C1111111111001
1011111111111111001
1000111111111100001
10000000P0000000C01
1111111111111111111