1111111111111111111
1000000000000000001
1000000010000C00001
1000000111000000001
1000001MCM000000001
100001C000000000001
100010100M1111M0001
1001111C000111C0001
10011111M0M111100M1
1011111100111110001
100101M110111111101
10011011100111111C1
1010011110C11111101
1011111100111111101
10111E0001110111101
10111C1111111111001
1011111111111111001
10001111111111M0001
100000MMP0000000C01
1111111111111111111